
permudah pengin jepang nih	neg
statement bodoh sekelas pejabat kayak	neg
yuk kabur	neg
pintar bijak	neg
meresahkan	neg
spesies kayak beban anjing	neg
ngeri wak serius	neg
tuhan turunkan penghakiman mu	neg
sekelas wamen bacotnya kayak	neg
sok asik	neg
sing urusan perut	neu
silaww	neg
sampingan kali	neu
dimanapun pemerintahan konglo ya kerja keras lihat respon pemerintah tuh ampun deh gue sadar ya kabur daya juang daya saing merespons kalo berkualitas kabur benaran dihargai ngeluh sih rakyat banget habis kalo kabur quality over quantity mumpuni	neg
gas pindah negara tetangga	neg
serius mentri	neu
catatan malaikat atid setebel ya bukunya nyatet kelakuan pemerintah	neg
contoh nyata pemimpin sdm rendah	neg
kwn	neu
dewasa ya responnya	neg
anggap	neu
iep pe tau nih negara miris	neg
tujuan ku	neu
serius bang	neu
tau pikiran orang kayak astaghfirullah	neg
sih suruh mengomong matiin kayak micnya	neg
mudahan orang kayak pas sakratul maut susahnya mati tbtb sekeluarga jatuh miskin masuk rsj kuat tbtb miskin	neg
lawak kocak	neg
takut	neg
kalo lu kabur neraka anjeng	neg
purik	neg
mah oke gas oke gas pindah warga negara sudi khianati pemerintah	neg
udaj kabur abisnya diam disana duit gaji kerja modyar kabur	neg
menantang warga	neg
ya elah noel mengomong otak	neg
pengin	neu
baperan	neg
kayak ngebayarin tiket lu melarang wkwkw	neg
heran mulut binatang menteri	neg
mengadi ngadi nih negara	neg
memiliki jabatan suara rakyat suara	neu
ah wamen nya	neg
rip	neg
kasih keras	neg
orang dewasa memiliki posisi pemerintahan berbenah polemik rakyat manas manasin rakyat pengin rakyat indonesia bodoh teknologi maju	neg
oh kalo bagus	neu
wokwokwokwok	neu
ngusir	neg
shapp	neu
menatap langit langit peduli esok pagi orang pinggiran frenky sahilatua	neu
amboi amboi gaji pajak rakyat terusan brisik banget mulut nya	neg
kacau	neg
cocok bang kalo tinggal indonesia bayar pajak apa-apa tinggal bayar pajak nya wkwk	neg
sekelas wamen	neg
suka ku urusan mu bjg	neg
salah pemain bersuara	neg
hihihi maaf	neu
lihatlah betapa enggan mencari solusi rakyat	neg
kocak nyuruh nyuruh gua kabur kocak gua cuman menanggapi statement kocak kocak komen mikir ya kocak biar kesalahan berpikir kocak	neg
bicaranya kayak digaji rakyat	neg
kabinet perasaan gara gara tabung ijo	neg
devisa negara hasilkan ln huhu kayak jadihya	neg
bayi tua puber	neg
mentri sampah	neg
menteri ambekan mending berhenti ditinggalin sakit	neg
sabar sewot	neg
uang milyar bkalan wna konoha hancur gegara ulah joninnya	neg
alasan orang aceh papua pengin pisah indones	neg
belagu lu	neg
kak han ek ta pikee donya kak akher	neu
wkwkwkkwkwkkwk	neu
apasi tahi	neg
anak buah lu tuh wo bikin malu kalo kerja buang	neg
gua cuman menanggapi statement lu kocak kalo gaji tinggal bayar pajak kocak hidup lu negara zimbabwe kocak kalo lu pemerintahan lu nyalonin kocak	neg
hidup enak digaji	neu
kayak jok agek diraguke nasionalisme kitoo haha	neg
cocotnyaa coba bacot pea diliatin	neg
kalo mama acc kabur	neg
gugel muncul	neu
tua bangka omon omon	neg
ayo	neg
kit ati	neg
mudahan klrg dikecewakan negara	neg
lu re ri a beb ikutan	neu
memilih masyarakat tersakiti masyarakat	neg
tuhan takdir hidup mati pilihan	neu
mending bpk kabur digaji rakyat dianya songong	neg
emosi ta sampean	neg
kalo kabur benaran disuru ya	neg
oopsiee	neu
kabur cari cuan aman kali ya	neg
ember entar bilangnya hack	neg
halah entar	neg
iya biar enak malkin nya bandara	neu
benaran deh duitnya mah langsung gas	neg
menteri ya bijak malu gelar ya orang berpendidikan bicara ya	neg
yuk rame rame bayar pajak mari lihatt nasib wai pejabat korup	neg
badutt	neg
id dibayar surga atuh malaikat mah wakil rakyat digaji rakyat tapiii mengkhianati menggaji	neg
semoga dipermudahkan ya	pos
pejuang devisa negara negeri lo manfaatnya	neg
menantang sih	neg
ya kabur ya awas lo dicariin anak berprestasi	neg
brain drain	neu
emosionalismenya kuat	neg
jepang yuk disuruh kabur	neg
mind blowing banget solusi solusi nya	neg
digaji pakai pajak rakyat berisik	neg
mendukung	pos
berkelas normal dipilih kemarin	neg
segini nih taraf berpikir wamenaker	neg
mengsediihh nya	neg
tolong	neg
mayah mayah muyu nih bapaak ah	neg
soon	neu
ambekan bzir	neg
muntah dengar berita	neg
wamen permudah usir warga negeri	neg
buset emosional banget	neg
mengsedihh kak	neg
let si go japan girls	neg
gas biar direspon wkwk	neg
yuk kabur biar bayar hutang	neg
sugesty pengin ngapruk	neg
mccartneys	neu
as if indonesia fasis rasis tuh prabowo openly praised fascist and authoritarian leaders kayak modi putin racism indonesia rampantnya bedanya orang cepat kicepnya dibales orang loud	neg
emak	neu
oke gas oke gas	neg
astagfirullah introspeksi yuk	pos
kualitas menteri	neg
mudahkan indonesia	pos
wkwkwk kocak heh nyuruh kerja disana bayar pajak anjeng ngegaji makan pajak rakyat petingkah	neg
wkwkwkwkwkwk	neu
san hidup dibayarin rakyat tabggapan orang ngegaji diapakan orang kayak	neg
ayoklah mogok bayar pajak bareng biar pusing sekian ratus ribu jutaan orang stop bayar pajak	neg
plis menambah beban bang	neg
indonesia kalo gajihnya kalo pajak	neu
menterinya sdm rendah	neg
terkonyoll	neg
pundung	neg
langsung tranding bang aselii	neg
ya mengambek an	neg
asli mentri dilupa brow digaji	neg
oh v oke	neu
bayar pajak dosa sih takut	neg
ngamokk	neg
malu malu pemimpinnya modelan	neg
galaknya	neg
kondisi indonesia nih kayak kondisi kantor ku bikin mumet	neg
id mas gib	neu
kabur dah indonesia kbykan populasi serius mah	neg
susah negara menerima kak malaysia menunggu diapprove	neg
wolah ra meneh rpp nek negoro wae ya ra ngopeni rakyat e duaarr	neg
ambekan kayak cewek pms	neg
kerja efek pemangkasan anggaran cung	neg
kalo rakyat pindah pejabat korupsi lo	neg
mikir ya tanggung akhirat kelak mengerii dipikir jabatan pertanggungjawaban	neg
h	neu
modal jilat wamenaker	neg
pengin kabur negara penuh korup	neg
emas	neu
iyo wa ayo kabur	neg
he is yours	neu
aneh kbur ditanggepi ngmbek dasar labil kalo negara maju perbaiki cuman bebankan dipemerintahan warga negara hak kewajiban kewajiban cuman byar pajak doang giliran pemerintah bikin program protes digoreng hangus sadar melarikan membangun mmng snggup bekerjasma yasudah pergi bagus mengurangi populasi	neg
dih sok petentang petenteng	neg
hoo hahahha lelah udahlahh	neg
betah negara	neu
berita sampah pernyataan sampah diposting media sampah cocok sampah	neg
yuk kabur yuk	neg
gue mah mending diam dikatai kayak bocah	neg
emosian banget	neg
bawa perasaan wkwk	neg
mengomong penjabat tunjangn nya	neg
hahahahha kon thol	neg
suruh ya gess wkwkk	neg
hahaha mengambek ya	neg
menteri kayak bocah	neg
kesempatan kabur rencana sih	neg
idih mengambek	neg
sih bawa perasaan bawa perasaan kritik masyarakatx	neg
jujur pengin pindah diijinin orang tua	neg
whoop menahan doi kabur loh komporin	neg
hadi ishaq ruqyah tadz kayanya	neu
shap	neu
wkwkwk mengakak baca respon lu thx deh meluapkan emosiku	pos
indonesia gelap	neg
terucap wakil mentri	neg
xian djing	neg
saking nggawe jj meneng wae penak og	neu
comment wamenaker wakilnya wakilnya wakilnya wakilnya wamenaker	neg
anak muda visanya habis	neg
masokkm	neu
ya terserah gaknya mengatur hidup orang kesana pakai uang	neu
sending virtual for you cantikku sayang	pos
gua kalo pemilu apalah malas memilih dipilih berguna	neg
nih gue kasih ludah cuuiih	neg
waras ya	neu
ya menangis loh	neg
dih bawa perasaan haha	neg
anti kritik pejabat	neg
pejabat mikir bebenah menyulut emosi warga	neg
responnya kayak anak gede	neg
dih kocakk emngg	neg
ikutaan	neu
rakyat bayar pajak setaun beli rokok kena pajak beli gadget kena pajak minimal kalo komen thlol	neg
karepmu semoga isi	neu
dzolimmmm	neg
hidup ayo cerita	neu
negara rakyat loh coba berdiri negara rakyatnya gaji duit gaji kerja leha duduk duduk sudut dunia bersusah payah mengeluarkan keringat jual mencari bayar pajak gaji orang beli barang indonesia pajaknya melebihi harga barang dibeli aduh mencari repot pengin duit	neg
komen diharapkan warga wakil rakyat berusaha kayak bkerja negeri menjanjikan ln pergi	pos
inc iya blah	neu
anteng ya disana diam disana pokoknya enak wkwk	neu
jawabannya berpendidikan mencerminkan kecerdasan mentri	neg
pekok pangkat piro sih iki	neg
nyinyir pejabat cari solusi bijak	neg
what is bro on about	neu
menikmati syukurin	pos
doang fasilitasi imigrasi iya menunggu evakuasi rakyat korban demokrasi	neg
menantang wkwk kabur bayar pajak lu gajian pakai	neg
i have sok much dream menetap kotaku terwujud deh memilih kerja lupa penyumbang devisa negara loh	neg
marah mentri kah nya	neg
oke besok kalo anak naturalisasi	neu
heran pejabat	neg
idihh awokaaok	neg
refleksi pemerintahan	neg
jepang ngopi bang	neg
huahhaa ya kaburr benaran kesel	neg
disamakan mati bangun	neg
wamen sumbu pendek	neg
reflek dih	neg
dubai doha orang filipina kerja airport spg berbahasa inggris ayo kabur persiapkan dirimu	pos
kalo gua xmen pejabat gua matiin model	neg
makan uang rakyat diam	neg
harap pejabat jabatan bekas relawan kompetensi	neg
gelo	neg
yaya ai sangkal	neu
permudah duit	neg
pajak pemerintah perampok duit rakyat	neg
lowongan kerja banyakkin batas usia pengalaman kerja sih mah aneh kerja dipersulit mah gaji masuk susah	neg
ganbatte minna	pos
lowongan kerja tolong ya dipermudah dipersulit perbanyak lowongan kerja nya batasan usia badan good looking tolongg ya pemerintah memiskinkan rakyat	neg
sjahrir tan malaka hatta said kasihan deh indonesia kalo gue	neg
dih really wakil menteri	neg
pemerintah tuh sindir lho mikir ya miris	neg
yeuu sih kocak	neg
kualitasnya nahkodanya kayak umur kumpul anak cucu bonekanya kakek mul	neg
kocak kasih solusi	neg
pengin bebas berkorupsi ya	neg
klarifikasi nya pas podcast ngalur ngidul nih	neg
korup cakep kerja solusi	neg
wamenaker beban negara berkurang	pos
loh kalo kabur bapa makan uang	neg
kuliah habis ratusan juta kerja mengabdi masyarakat kerja jam gaji ribu mensejahterakan hidup orang hidup	neg
mengomong bocil	neg
setuju sih biar orang merasai minggu ya senang bahagia alamak	pos
setuju	pos
dih ngocol	neg
anjay menyala	neg
something with human rights and better laboratorium of work reglement	neu
wamen sadar gaji	neg
harga nynwarga indonesia negaranya	neg
kalo indonesia stop bayar pajak lu	neg
gua stay brunei indonesia rakyat injak hargai pemerintah	neg
memilih prindavan jen	neu
kabur yordania	neg
ketikannya baperan kayak cewek	neg
kasih paham bang	neg
wkwkw prindapan zero higenis	neu
garang kali bang	neg
berbenah menyalahkan masyarakat	neg
oh orang	neu
betol kali sih lapet	neu
kayak abizar kemarin	neu
kalo krisis warga negara repot lho	neg
capek banget	neg
mas pragiwaksono tuh memilih kalimat kalo mengomong tuh takut mengomong	neu
oknum blunder abidzar	neg
b	neu
pundungan	neg
cie pms ya	neg
kejarlah cita mu langit mendem indonesia kemajuan kalo negara mahhh capek deh	neg
ngusir nih yeh	neg
berasa ngegaji wkwk	neg
byon combat enak nih	neu
mee	neu
ajak bang entar kepancing aslinya omongannya bobotnya wkwkwk	neg
balikin uang rakyat bawa perasaan	neg
bosskuu	neu
mentri lol	neg
bisanya mengomong anak bpk ungsikan negeri hidup enak mewah fasilitas gamungkin tinggal dikonoha	neg
sok asik anjir	neg
iya uang hasil kerja keras dimakan	neg
ngising	neg
baca coach	neu
ya salah orang kemauan betah indonesia	neg
beuh	neu
ngamok namanya orang tua ngamok ya	neg
menteri cari solusi kayak terkait nanggapinya aneh banget wkakwkak ya ginilah posisinya aman menanggapi coba kalo posisi nya dibalik	neg
oke acc	neu
sugesty kesel	neg
dnda	neu
anjing anjing	neg
otw shiga	neg
gass bang	neg
orang pusat tau	neu
gass broo	neg
bacot orang jabatannya kasih gara menjilat kayak introspeksi tolo ll	neg
ayokk kabuurr guys semangat	pos
nylot anjir	neg
syibal lu deh pindah indonesia	neg
lucunya negeri rakyatnya cinta tanah air pemerintahan nya	neg
kalo mencalonkan sok pas pejabat mulut	neg
lo mengambek kayak hubungan percintaan yauda kalo betah pergi cari orang	neg
cpns masuknya test menterinya statement nya kayak bocah	neg
kacaw ya lan	neg
bang	neu
mikir tahi cosplay bocil	neg
ajak kak	neu
mentri opo koyo ngene kui	neg
bawa perasaan	neg
kabur rahasia negara aib terbongkar	neg
mencari solusi statement bodoh	neg
gue hidup eropa berasa beruntung tinggal indonesia pulang kerasa bedanya minusnya tolerir gue tinggal eropa open minded mengajarkan gue arti kemanusiaan negara manusiawinya rakyat	pos
ngambekk sih woii lu digaji mikir orang bangun negeri	neg
pejabat egois nya berbenah membiarkan anak negeri pergi nyebutt	neg
meninggalkan konoha	neg
solusinya diundang podcast menyuarakan rakyat	pos
responnya mencerminkan kinerjanya	neg
coming soon passport	neu
wediku ubah gender dek	neg
wamen cetdass	neg
merajuukk	neg
oke gas	neg
respon menaker positif aneh respon negatif	neg
ya lu kabur anjr kabur	neg
wni	neu
baca deskripsi groub	neu
iya iya tua mengambek	neg
alhamdulillah sih gua kalo pergi negara	pos
wkwk master	neu
maklum bocil	neg
bang malu maluin	neg
jujur sakit hati sih bacanya wkwkwkw	neg
bukanya mikir emosi	neg
tombol dislike sih	neg
wajarlah menteri nya kayak lihat kualitas pemilihnya kayak	neg
pemerintah ambekan kalo pajak nurun menangis ya	neg
lucu	neg
pembalasan kabur loh bilang temannya watados makan uang rakyat	neg
labil	neg
aduh menteri kaya gapeduli	neg
tipikal pesimis wkwk	neg
mah mantap niat	pos
membicarakan sakitnya airmata	neg
ututututuu	neu
hmm menarik kau hahahaha	neu
anjgggg	neg
wa otw brandoo biar sehat jiwa akal	neg
aussie nih mas gaskan merapat	neg
sulit	neg
yeu kocak	neg
ow kaget	neu
kagak mending naturlisasi berguna diapresiasi negara	pos
baperan kali pejabat	neg
anjir nyelekit	neg
san info bang kesana nya	neu
kalo tau tanggapan pemerintah	neu
heran ya nama nya negara konoha	neg
dipilih sih presiden	neg
aaawww	neu
apandeh pemikiran nya nih sdm nya kerasa banget bilang orang wkwkwk lu tau tinggal negeri kalo lu lu lihat orang terlantar jalanan	neg
deloken	neu
bari sapa sing pn sih	neu
berkembang bervalue cari dimana dihargai berharga	pos
ditinggal sumber pajak gengsi	neg
gue bilang	neu
tombol ludah	neg
sadar menantang	neg
hasil pemikiran memiliki negara memperkaya benat pemikiran anak sekolah papua	neg
wani mulih pora jane	neu
menteri	neu
ahaha kocakk	neg
marahan nih orang teman tongkrongan	neg
dunia era digitalisasi generasi memilih pekerjaannya contentcreator pekerjaan freelencer bingung melamar kesana panggilan contoh nya kakak lulusan sarjana detik panggilan kerja bu	neg
amin murah wna dibanding wni	pos
der solusinya	neu
ya oke	neu
pengin ajak podcast	neu
cie mengambek	neg
dicopot dicopot bro	neg
kasih paham kohh	neg
gasss	neg
pahlawan devisa	pos
kocak wkw	neg
mentri kalo jawabny doang	neg
mengapai	neu
amit	neg
ku kasar nntik dibilang sopan statmenya greget bikin darah tingkat	neg
otak kosong temannya sih john beda	neg
hhh otw	neu
pemerintah ngandelin pajak rakyat lho kabur benaran nanges	neg
generasi kolonial mah amatiran	neg
we are cooked ppl	neg
benaran jawabannya	neu
harapan hidup wakanda	neg
doa restu kabur	pos
spill gajinya ngab	neu
lolll	neg
marah	neg
kagak anjg	neg
minimal mengomong urusan negeri diperketat susah niee rakyat nya	neg
susah pap temenannya firdaus oiwobo	neg
wajib militer	neu
sayless	neu
wkwkwkwkw	neu
aman pakk lulus kuliah langsung cabutt	pos
nya cugetan wkwk	neg
kerja nya menonton bok p korupsi tuh bang	neg
loh mengakak banget responnya wkwk	neg
anjay ngusir	neg
awas ya nyariin	neg
tiktok brain sih	neg
masyaallah keren men	pos
jiah	neu
hahaha iya	neu
panas hawane pdh musim ujan	neg
san tolong ajak keluargaku	neg
asli dit	neu
menteri sapu dada sa jiwa maki meronta ronta	neg
pejabat	neu
kalo kabur makan uang pajaknya dikit	neg
pemerintah proses biayanya senang hati ln	pos
kesel wkak	neg
ringan banget mulut ngejawab	neg
katro ya guru	neg
pemerintah meredam situasi bikin emosi kayak tau pemudanya betah indonesia perkaranya cari solusinya nantang pemerinta bikin indonesia emas mbok bikin bikin indonesia emas pembentukam bibit pemudanya pemerinta kalo duit doang kerjanya cekatan najis	neg
maneh gaji pajak rakyat rakyat kerja diluar negeri	neg
widiih mentri	neg
kalo kabinet dibentuk bowo kagak	neu
gelapin dana lo	neg
prabowo dipilih berkali kali sekalinya kepilih bikin ruwet jir	neg
bela menteri blangsak kayak lu kabur nih ya belajar bahasa inggris njer boro boro belajar bahasa inggris game bahasa indonesia teriak gua belajar bahasa penjajah	neg
kangaenakutemoii	neu
wamen goblok	neg
palalu gua jadikan roti croissant	neg
florestattoostudio	neu
menuntun anak anak ku biar	neu
ckckckck	neg
n sih disuruh yeng	neu
lihat wamen lihat potongan pajak slip gaji rela lihat pajak gue dipakai bayar gaji orang model	neg
sekalinya ijinin kabur tahan rada aneh sih nih menteri menteri	neg
salah pelaku korup	neg
kecap	neu
kalo rakyat gaji lo kocak	neg
pengin banget kabur indonesia dipersulit adminstrasi dll	neg
yeah	neu
sok iye lu ngnt	neg
hem	neu
jgj nderr	neu
istilah namanya gue mengetik tersurat menyesuaikan kapasitas berpikir lo	neu
rasionya pajak bnya tertata gaji melintir wkwkwk	neg
enak sih ajak keluarga ganti warga negara	pos
palapamuda idn pamit	neu
deh kesel kocak ya	neg
miris yakan	neg
hubungannya ppn merespons statement kekanakan menteri akun sih menteri lompatan logika anjir menyambung orang	neg
entar kalo kabur lu bingung entar gaji lu sape coba kalo pergi biar gantikan kompeten	neg
mas spenuhnya ngandelin pemerintah kuffur nikmat kaya sodara dipalestine alhamdulillah	pos
tau alamat monyet	neg
bapaknya loh rek suka emosian kayak kaca pemerintahan	neg
naa kekmana kaburlah jepang	neg
sok pentang tang petenteng giliran rakyat turun tangan kayak ayam sayur	neg
gila mentri didunia hahaha tunggu ye akherat	neg
tepatnya	neu
bocil byr pajak sok mengasih tau pajak	neg
sabar ya nyiapin berkas	neu
bagus kalo balek indonesia lu mandul ya	neg
pulau jawa pulau terpadat dunia penduduk juta jiwa bandingkan australia juta penduduk usia produktif sulit bersaing pekerjaan layak pemerintahan indonesia kacau bayangkan kedepan pilihan selagi kesempatan peluang gass pakai	neg
permudah apply visa kali gagal lengkap jelass	neg
kasih paham cong	neg
wkwkwkwkkw bawa perasaan	neg
tenang kabur	neg
disuruh pakai otak gue tulis demokrasi kunci lu mengatai orang respon statement menteri bawa pajak istilah orang cengeng gue kasihan lihat statemen kosong lu kalo lu tau belajar orang sdm unggul aware pajak pemerintah lu keren ikhlas bayar pajak namanya pemegang kekuasaan lepas tangan bangga minimal mikir bang	neg
permudah jalurnya dipersulit	neg
negara menikmati penghasilan negeri ngacoo hansip lo noeel terhormat	neg
haha bodoh ya baca komen gue diatas lu ikhlas bayar pajak lu	neg
banget awas lu ya	neg
haha	neu
pikiran nya ora	neu
permudahlah duitnya gue tinggal monaco	neg
komen doang salah lu mengajari orang merespon tingkah absurd pemerintah komen lu merendahkan rakyat bawa pajak kalo lu action langsung ya silakan btw ppn tuh barang mewah barang indomaret tuh masuk pajak semu gue lihat komen lu paham	neg
apbn terbesar ajak bro	neu
siapp pakk doainn ya aammin keras	pos
ambegnya gede	neg
iya komen doang nerapin frugal living kemarin nge trend kalo ppn sahkan memilih tersakiti komen sosmed gaji rakyat blablabla berharap wamen statement sadar	neg
hah serius mengomong	neu
yaayy im happy	pos
sabar abangku	pos
sampah boomer terima kritikan lihat	neg
mutung	neg
paten	pos
gas gelar bang	neg
mentreri	neg
main mentri mentrian kah	neg
gaji duit pajak songong nya naujubilah dasar beban negara	neg
sekelas wamen negara indonesia	neg
gue lipstickin lo	neg
menyusul bos	neg
ditantangin mut atur jadwal	neg
semoga negara memadai menghormati	pos
arek iki kakoi dana	neu
makan duit rakyat sok belagu sadar mala tantrum hadeh	neg
yaelah mengambek sih mengalahkan sih cewek gemini nih mengambeknya	neg
gua rencana entar kalo bekal tinggal singapore pindah kewarganegaraan menetap tua	neg
kogh marah halangan ya	neg
idih tantrum lu	neg
menteri baperan taeekk	neg
gapapa better negara orang negara	pos
dih sih	neg
berani podcast bang	neu
disuruh cabut	neg
kabur menengah kebawah negeri cuman tindas sistem hukumnya sistem kesejahteraannya amburadul lamar kerja persyaratan bahasa asing emanya nih kerja negeri sah sah ee warga asing masuk buta bahasa wajib berbahasa	neg
mentri namanya cocok orang tongkrongan	neg
sayang less	neu
jabatan belagu kerasa dibawah	neg
presiden lihat nih	neg
sarana kaburannya kak	neg
bagus biar sdm minus netap dibindo indonesia emm mas tf	pos
dih dih diihh bawa perasaan	neg
witanta lowong cenah sayang gas moal	neu
bawa perasaan deh sih	neg
julid sengke bangkai	neg
ok rencananya	neu
sok suruh pulang gaji lo hah	neg
mentang kabur duluab	neg
screenshot renald bahan affidavit wkwkkwkw	neu
mestinya pejabat sadar ketidak mampuannya membuka lapangan kerja pekerjaan gajinya rendah diindonesia pungli premanisme koruptor mestinya introspeksi leadaan nyinyir	neg
indak kabur yan	neg
wkwkwkwkwkw kocak	neg
menteri bocah	neg
tua puber	neg
statementnya	neg
sekelas mentri loh mengomong anak sd kali kalo cuman mengomong doang nya diresearch fenomenanya	neg
singkat ok acc	neu
ngusir lu blok	neg
berharap komen diatas berharap sadar kalo gajinya rakyat ya orang kayak mah rugi dilakuin terusan nyumbang pajak ppn makan resto top up game dll memilih komen sosmed doang pilihan tangan kalo diatas sadar dibawah rugi ya berpikir	neg
gas bang	neg
astaga banget wakil menteri	neg
kacamata ngentot	neg
kayak kayak	neu
top komen	neu
oke kalo uangnya permudah urusannya	pos
jepang	neu
bukanya mengasih solusi nge bacot	neg
wkwkwkwkwk kocak	neg
tim tombol pecat ajalah mentri biar	neg
banget	neg
tolol lu ya	neg
betah cik	neu
berjuang hidup silakan dimanapun ln indonesia hak konsekuensinya ya diterima mengapai generasi baby boomers millenial tantangan kesulitan dihadapi pribadi sosial ekonomi dsb kalimat hastag jumpai generasi kompetisi dalan kehidupan tinggal menyikapinya bayangkan penjajahan revolusi kemerdekaan pejuang rakyat indonesia disuguhi hastag namanya indonesia	neg
pemikiran setara bocil kepemerintahan sih	neg
cahaya terang banget	neu
malu kebijakan dinegara dinegara orang diperlakukan manusiawi miris banget	neg
pergi ya tinggal pergi mempersulit	neg
gas coba pikirannya manusia	neg
hadeh wkwk	neg
pikir uang gajinya darimana	neg
cie ngambeg	neg
kasih jabatan songong nya ketulungan	neg
kelas banget jawabannya	neg
salah penyumbang devisa negara terbesar ratusan triliun pertahun pekerja negeri	neg
ikuzzo senpai bakar bakar bakaar	neg
bjir	neu
hahahahahahhahahahhaa	neu
gua tag nih orang nya	neg
ya allah	neu
makan duit rakyat berisik banget	neg
bawa gembolan	neg
bacot anjing	neg
san kasih paham bang	neg
mengasih ge kesulitan	neg
iya	neu
gue aussie beli bmw zx kalo indonesia kacung korporsf gaji sebulan menyambung nafas	neg
gatel banget gatel ptn kayak nih gua langsung turun	neg
awkwowkwkw lucu banget kayak bocil ledeki abangnya	neg
kalo benaran kabur gaji drmana wkwk	neg
ya rugi statement wamen diatas dilakuin komen doang nerapin frugal living memilih makan resto kena ppn habis komentar sosmed gaji pajak rakyat blablabla aneh	neg
ginih nih buzzer jadikan wamen bknnya mikir	neg
maju wkwkw introspeksi sulit	neg
irsyd definisi mempermalukan sendir	neg
hahahaa	neu
minimal maaf kocak pergi alasannya situ tau alasannya kocak	neg
terimakasih bersyukur	pos
nya mentri pintar	neg
mood ya	neu
duh terheran heran	neg
don t hit the door on your way out ah response	neg
lo enak kabur tod	neg
hidup negeri dongeng	neg
tenang kabur negeri orang hargain konoha dikit kerja lihat umut pakai koneksi ordal blaa blaa	neg
ben ben	neu
permudah anak muda kabur urus paspor dipersulit orang mesti jalur calo lolos	neg
sentil habis an wamenaker nya kasih paham	neg
lu sembarang mengomong ya mentang pejabat lu	neg
ajak banggg pliss	neu
kayak anak mengambek	neg
coba kasih gaji juta tunjangan dll kagak	neg
puncak komedi	neg
nge grutu cepat mati loh cepat sih	neg
apan	neu
kayak anak anak anjir	neg
kocak mencari solusi orang mengambek	neg
ngambekk	neg
merajuk	neg
bayar pajak loh	neg
anak bini lo makan pajak gue belagu	neg
kabur ya kack	neg
menang tebal kaca mata	neg
roma firdaus susah cari kerja indonesia penduduk kualifikasi kerja masuk akal gaji sebanding perusahaan pasang syarat kayak lulusan si pengalaman bertahun gajinya umr standar sdmnya memenuhi syarat data persentase sarjana indonesia tenaga kerja asing masuk bikin persaingan ketat jaminan penduduk dikit otomatis kesempatan kerja	neg
lucu pengin gua lempar batu	neg
heran orang pejabat pejabat welcome kritik masukan diajak debat	neg
kayaknya pengin kabur sih cuman biaya wkwk	neg
ih merajuknya nyoo	neg
sih	neu
respon bijak sekelas pejabat	neg
ngeluhin pajak perasaan mengomongkan pejabat digaji pakai uang pajak rakyat deh mas pintar dikit rugi	neg
mengasih solusi ngusir kocak	neg
jepang yoh	neg
utututu mengambek ceritanya	neg
menantang nih wkwk	neg
kabur rumah mamak deh ijinin suruh kabur maunya nih	neg
yaudah iya	neu
ngontol	neg
tone deaf	neg
mengurangi pengangguran indonesia	pos
mandi	neu
tipe anak tongkrongan kalah debat teman haha	neg
mah persib teh b nya boston	neu
melu wae	neu
sumpah kalo duit kabur	neg
orang menengok keluarga doang deh kabur negeri orang balikk	neg
mentri menstruasi baperan awas kuda lumping mentri nya ha ha ha ha makan beling	neg
kabur lo sontoloyo	neg
besok indonesia pet biar lu aman sejahtera	neg
sombong	neg
kalo menjilat atasan jago masyarakat pinteran dikitlah menjilatnya hidup susah minimal senangi dikit	neg
nih pejabat kayak rakyat loh	neg
gue mah kismin bang kagak makan resto	neg
sikat pakai sikat penghilang karat baja biar termurnikan pakai pemutih nya	neg
kabur yuk sepikan indonesia	neg
gassss bang tag orangnya	neg
eh agung ayo gung	neg
untung benaran kabur bawa perasaan banget kayak bocah dosa lu nama lu keberatan sesuai akhlak wkwkkwwk pookie	neg
iya kasihan gue mbak makan resto kasihan orang makan resto ngeluhin ppn	neg
jujur kecewa responnya	neg
bro sadar gaji bro tuh rakyat bro membiarkan rakyat kabur negara bro nya ikutan kabur tau lihat	neg
diiyain	neu
kocag	neg
seberharga	neu
kalo bilang urusan visa an mu persulit kalo kabur wkwk think before talk sih ikhlas kabur makan mewahmu bayarin bbm pajero mu	neg
wokeh	neu
ketahuan kalo pemerintah peduli rakyatnya sakali mah mikir lamun teu aya rakyat moal janten nanaon sakitu we ti abdi mah	neg
bijak pejabat indonesia	neg
wkwk otak pakai deh daritadi ngevonis gua doang lu ikutan komen kayak diatas gue mengetik kuota rugi kuota pajak	neg
ya allah beban rakyat endonesiah ya	neg
are you okay bro	neu
kalo dirimu masuk wakil menteri ketenagakerjaan jalur orang mencari solusi nylahin rakyat salahkan rakyat mengecap dirimu wakil menteri ketenagakerjaan bersdm rendah pola pikirmu mewakili kaum sdm rendah salahkan	neg
menafkahi pemerintah sapa kalo rakyat	neg
sori minimarket ppn kalo gue isinya bahan pokok barang mewah pemerintah kemarin lu kali mbak wajarlah kalo lu ngeluh ppn	neg
bagus lho mengurangi kepadatan penduduk	pos
asbun banget nih orang	neg
true brother	pos
tone deaf sumpah	neg
qish qish qish	neu
anak buahnya sih modelan rakyatnya	neg
belanja ya jajan cafe restoran ya gacoan kasihan tau ppn wkwkwk	neg
kabur saingan pemilu	neg
aduh aduh sayang louder brotherr wkwk	neg
wkwkwk hatinya tergores lucu orang tua	neg
they don t need us	neg
ngerekrut stafmu sih metodenya nitip japri bisik sih stafmu kayak manner melayani rakyat	neg
mentri mulutnya disekolahin adab hidupnya numpang rakyat	neg
pemerintah ci mehong beda nya anti kritik	neg
visa kerjaa wkkw	neu
kalo orang financial bang currency kuat spending currency lemah emerging market kaya indonesia intinya	pos
terima kasih	pos
wkwkw bapaknya pengin kabur sebenenrya	neg
otak kea pelaku korupsi	neg
mengadu allah negara adil menenangkan hati	pos
fr entar kabur bikin kebijakan aneh alasannya memaksimalkan tenaga kerja negeri pengurusan imigrasi dirubah banget pejabat isinya suka tantrum	neg
orang mengayomi pekerja ngoming orang betah kerja disuruh kerja mencari pajak gaboleh	neg
tunggu	neu
sok tau lu bang	neg
majok nicc ya	neu
mari membayar pajak kalo bagtu berpendidikan mulut didik	neg
siri kabur bayar gaji kelian entar sapose first class negeri	neg
mengomong mewakili kualitas orangnya	neg
oohh	neu
japan	neu
bawa perasaan pemerintah	neg
kayak cewek berantem cowoknya yaudah pergi	neg
awak selatan utara	neu
lihat gue aussie wkwkk	neg
anak kalo marah	neg
nantangiinn	neg
no wonder	neu
yes warga dunia wni	pos
pemilu kagak kocak	neg
kayak hidup rakyat	neg
oemasukan pajak kelen berkurang	neg
paberan kah indonesia sulit sekolah digaji juta perbulan pikirlah pajak sadar bayar gaji bapk loh	neg
gaji pajak congor dikondisikan	neg
pemerintah kritik kritikan	neg
mental ambekan mentri	neg
coba lu rakyat	neg
mentri gakeliatan hasil kerjanya	neg
etdah gaji rakyat belagu banget guah	neg
gaskeun	neg
wehh kalean wkwkw kwwkkwkw	neu
biar kosong jual pulau	neg
pemimpin kinerja nya hargai rakyat tolong harga rakyat kerja keras membangun negeri hargai setetes kerangat nya kalo upah beda kalo rapat tidur slot dll	neg
akunnya kekunci deck kena mental ya feeds nya berisi foto alay kayak jamet bti bisnis	neg
nice respon	pos
wamen mulutnya	neg
pernyataan	neu
kadie merapat	neu
lowong pisan mangga	neu
dih btw ramadhan min	neu
dih tua tantrum wkwkwk	neg
lu pajak stahun doang anyink lu makan resto ppn lu beli barang barang ppn kena disaat beli banget anyink	neg
malu sih masak iya mentri mulutnye selemes	neg
like komen ya	neu
kualitas wamen hasil give away	neg
bezir menantang	neg
diusahakan doain ya	pos
gas trending	neg
iyain salah mengapai memikirkan gaji pejabat ya biarkan gajinya dkit kalo kabur	neg
kalo kabur gue jujur sih betah dinegara orang	neg
dikritik evaluasi mengambek	neg
dih tahi	neg
paraahh	neg
hahahah	neu
kuasa sih bpk peduli deh	neg
tolol mulu rend	neg
mental	neg
orang mentri ya	neg
cayang nya	neu
koo wakmen ya kak	neu
salah bentuk pelarian tanggung solusi menambah	neg
pakk	neu
mengomong kerjanya	neg
mending bayar pajak	neu
gaskeun kalo rakyat lo orang makan jier	neg
gayamu pajaknya mahal heh	neg
ta ngko samean gaiso entuk uang pajek rakyat lo lek kabur kabeh	neg
a inn anee	neu
centang biru doang penulisan nasib tau pantesan indonesia gamaju maju followersnya	neg
ngentot pejabat kayak goblook	neg
kocak haha coba bpk berhenti kali	neg
lho ngamok	neg
gue kalo visa pr canada australia cabut kalo ganti paspor harapan negara dipegang bandit	neg
byee indonesia ya	neg
pajak nya ya	neg
biar negara pemasukan ges maksudnya	pos
semoga swasta mengasih jalan benaran pindah kerja ln	pos
ambekan banget	neg
maklum kapasitas buzzer mencari solusi dibayar pajak rakyat	neg
sih sekelas mentri lepas tanggung	neg
oke dicopy	neu
wkwkwk lucu	neg
kualitas nya	neg
yaelah lisannya seram banget	neg
turunkan jabatannya	neg
belajar kelola emosi menteri	neg
yaudah lu kabur tinggal kabur kocak mengapai lu memikirkan gaji dibayar pajak kocak	neg
orang kapal jepang kabur bang andai persulit ninggal gadai indonesia mayoritas pengin kabur indonesia	neg
maklum toddler	neg
mls kasih makan binatang pajak	neg
jajaran malu teh wamen menjembatani sumbu pendek hih miris mah	neg
bunda	neu
dih moodyan kayak cwk	neg
pas pemilihan melas melas baekin rakyat pas kepilih idih najis	neg
kabur pindah negara indonesia maksudnya kabur mencari pekerjaan negeri terkumpul beli produk negeri	neg
pindah indonesia lapangan kerja kualifikasi melamar kerja diluar nalar ordal skill diatas kalah ordal skill wkwkwkwkkwkw	neg
komedi	neg
si acc gass	neu
bpk sober	neu
response unwise at least generasi muda stay indonesia kasihlah pekerjaan ubahlah peraturan dimana umur orang maybe more tahan that	pos
lur	neu
baperan banget gblh bawa perasaan entar cepat meninggal	neg
negara anti kritik introspeksi pundungan	neg
bilang hdupnya djamin negara	neg
hahahaha bijak banget pemerintah	neg
lol	neg
yeu bawa perasaan wkkwwk	neg
san terima kasih bang mencurahkan isi hati	pos
ok pakk	neu
tengkyu	pos
angkatan pemerintahan katro banget	neg
stay ngurusnya ogah ogah an giliran kabur mengambek	neg
mentri lo anakku sd mentri kayaknya amin	neg
nya pejabat kayak ya kayak perduli rakyat anjay	neg
sdm rendah	neg
p e a	neg
iya syukurlah digit kesel banget pemerintah gue setor segitu	neg
iyadeh lu pendukung pemerintah kesalahan apapun btw biasain membandingkan kesalahan bikin salah satunya public relation nya jelek sekelas orang kabinet menunjukan berpikir pendek bijak lu setuju ya lu kayak yaudah apa-apa orang sejenis sdm nya case closed	neg
mengasih lapangan kerja bagus aturannya aneh aneh mengomong kayak wkwkwk oalah	neg
gue pengin	neu
kebanyakan komentarnya mengarah negatif lulusan salah program kemnaker berusaha pelatihan skill kerja i just want sayang maybe he si telling the truth knowing that there si no hope for indonesia	neu
kualitasnya berfikirnya	neg
istighfar donatur kekayaan loh	neg
semuak pemerintul	neg
indonesia memanfaatkan dukun nyantet	neg
duit lu darimana	neg
bawa perasaan sih	neg
nih kakek tua sih indonesia	neg
off baperan	neg
gaji nya sono kucrut tahi kucing	neg
bocil	neg
wamen berpikir nya baperan cepat putus asa	neg
aing pelatihan sertifikat bnsp permudah lamar kerja teman teman bilang program salah bermanfaat makan uang pelatihan pas era presiden pelatih nih dana kemnaker dipotong efisiensi fasilitas penunjang pelatihan berkurang kuota pelatihan berkurang sayang orang skill apapun kayak pekerjaan program membantu banget	neu
banget guys indonesia ditinggalin gaji pas pasan kebutuhan mahal mahal dinegeri inidonesia ekonomi	neg
hilih digaji rakyat belagu lu	neg
cuss kaborr	neg
whv tolong diperpanjang haha	neg
orang kocak kocak deh pengin kabur memikirkan gaji pejabatnya logika dasarnya mengapai lu memikirkan orang memikirkan lu kocak kabur lu indonesia maju sdm kabur	neg
gajimu lupa ya kalo gaji rakyat lupa	neg
fjar wkwkw	neu
bapernya lucu	neg
pejabat mikir perutnya	neg
lihat nih menteri bicara	neg
pemerintah diganti pakai umbian	neg
permudah	pos
kabur bantu berproses mendapakankan pekerjaan terbaik	pos
pakai vibesnya president indak mu	neg
hujan emas negeri orang hujan batu negeri	neg
netflix nya readyy bun	neu
wakil menteri mengomongnya pemerintah berpikir menyejahterakan masyarakat nya kabur	neg
wamenaker sejenis binatang ya serius	neg
kabur nih	neg
realita menyediakan lapangan kerja rakyat disuruh kabur	neg
kalo buzzer wamen kali ya	neg
sekelas menteri omongan mulutnya nya kayak	neg
kualifikasi pekerjaan indonesia max umur termsuk lansia	neg
sih mentri baperan nguasain emosi	neg
cemen	neg
hah	neu
yaampun	neg
memilih	neu
layaknya siput mati cangkangnya wkwkwkwkwkwkw	neg
kamplengi ndase bae	neg
istigfar gue mah	pos
ayo min gratis	pos
permudah plis	pos
prabowo kue wamen nya anak anak	neg
langsung kasih contoh pejabat bikin warganya kabur	neg
manusia mending hindari dosa masuk neraka ketemu bahlil teman temannya siksaan neraka hina	neg
let si go	neg
orang model desa terpencil	neg
ambekan ah	neg
bahan evaluasi ih malu deh tua berpikir siy	neg
gaji lo rakyat bilang bgytu bayar pajak biar efesiensi prabowo kalo mentri kena pengurangan	neg
baperan banget anjir apakabar pemerintahan korupsi nya	neg
pemikiran bodoh hawa nafsu bukanya mengasih solusi	neg
kabur yordania presiden	neg
menantang ya	neg
ketawa mah jabarin dahlah	neg
kalo mengomong enteng banget lu lu mentri mencerminkan mentri tau bknya mengasih lapangan pekerjaan rakyat indonesia kesusahan cari kerja enteng banget lu ngrasa kesusahan ya enteng mengomong bgytu	neg
kayak orang kasih gaji mandat kayak monyet ya	neg
refleksi dangkal nya level intelektual	neg
intropeksi sok kerad	neg
memangnya sih manusia kayak kadang kesel emosi kadang ngawur kayak manusia kalo lihat pejabat ngrespon bijaksana diam menyakiti rakyat pejabat menyakiti hati langsung kasar	neu
yuhuu kene kerjo mpotan je congg	neu
kalimat khas boomer kolot	neg
hehehe	neu
fact	neu
cari solusi wkwk	neg
kayak cwk ambekan	neg
wamen loh terhormat jawabannya anak berpendidikan	neg
ahahaha sibal sekki	neg
wamen daal	neg
yuk pindah yuk ongkosin gue	neg
majuk	neu
heran negara tertinggal bercermin singapura menarik orang pintar kenegaranya	neg
wamen yakaan	neg
mulutmu harimaumu	neg
dasar orsng tua caper	neg
acc koo	neu
statement nya nunjukin kualitas	neg
responnya bijak blass pejabat wamen t	neg
solusi dibiarkan	neg
dipilih menteri	neg
kayak masyarakat vs pemerintah	neg
laksanaken	neu
jiakh entar kabur benaran menangis	neg
okeee	neu
pengangguran indonesia kayak wamen nya kayak mikir rakyat indonesia cari kerja nya gampang wkkwwk mentri wamen duduk kursi pemerintahan dasar politik	neg
contoh pejabat pemerintah cepat mulut otak	neg
wamen	neu
kabur dipermudah aneh lo	neg
sekelas pejabat kayak	neg
okee gas	neg
skip baperan	neg
suguhi makan bergizi biar cerdas dikit	neg
amin kencang	pos
ambekan kayak orang puber anjrit	neg
nya mikir rakyat nya kabur perbaiki sistem perbaiki kesejahteraan mengambek bocil terjebak tubuh dewasa ya syusaahh omongkan angel	neg
duh wes gendeng dunia iki	neg
duh kapasitas pejabat introspeksi baperan kayak mantan	neg
peduli emas konoha	neg
hanifa pakai mikir kali sih	neg
kasih paham guru	neg
amin	pos
menarik	neu
ya negara nampung warga indonesia langsung daftar	neg
unqualified people still got the job government	neg
nantang	neg
kabur nih ongkosnya	neg
wanjaaay	neg
tantruman	neg
ok gass	neg
tuh tantrum	neg
anak muda sbnrnya halangan kalo semunya berangkatmah sepi	neg
otw nih mohon permudah ya	neg
halah halah	neg
serbu blacklist sih wamenaker mengambek	neg
omongan indak mencerminkan pejabat ya tunggu klarifikasi nya	neg
bang eren	neu
bismillah	pos
maksud tuh kalo kabur kabur jutaan warga indonesia	neg
respon bijak	neg
dlok biak sambas kabur malaysia daan pakai hastag agek	neg
exactly	neu
toddler could speak even better	neg
joman	neu
baperan ya kasihan muda	neg
kabur kabur btw permudah pembuatan visa wkwkwkwkk	neg
gas koh	neg
anjay	neu
paham awali tutup kalimat sdm om	neu
tolong ya wamen diurus diperhatikan	neg
ig nya	neu
yaudah iya salah	neu
gajinya masyarakat bocah anti kritik	neg
londo ireng	neu
barudak jaman ayeuna mah moal disungkun dikieukeun nya kalah atoh ngahajakeun wkwk	neu
negara penjara	neg
bocah	neg
nggakk heran warganya padapengen kabur pemerintah jajarannya menutup telinga p	neg
p pergi hmph	neg
apapun beli barang makanan supermaket minimarket pajaknya baca deh struk barang beli dibawahnya tulisan ppn	neg
prabowo sih anak buah nya pekerjaan nya busuk dibiarkan	neg
ayo loker wamenaker	neu
bilang prabowo noel pas kabur yordania	neg
komen menampak paham rakyat merespon tindak tanduk pemerintah menghubungkan pajak minimal lu mengerti konsep negara demokrasi komen lu yagitu deh	neg
oon	neg
mulut gede otak alhasil kosong	neg
blunder	neg
kabur banyaknya makan uang pajak simiskin beranak pinak pejabat	neg
orang kocak ya jabanin biar dah bodoamat gue mah kalo sih pindah kewarganegaraan gue mah	neg
gue tulis sdm	neu
main menterian banget jawabannya	neg
mengasih solusi mengomong kayak ketahuan banget tuh becus kerja nya	neg
solutif	pos
ooo giliran memeras nongol lo	neg
baperan ya mentri mentri	neg
kabur ditawarin gawe indonesia wkwkwk	neg
yeuu kocak mengambek	neg
amin ya allah yuk yuk diusir indonesia kayak kayak miskin miskin	neg
mentri kebijakan bilang	neg
hahah asem	neg
ya malas banget	neg
gaji wkwk	neg
kabur lo mati parahnya tuduh pembunuh	neg
doain buruk takut doa cocok sih gaes	neg
kalo tau semalem diskusi tvone bunda corla perwakilan nya nya merhatiin main hp mulu greget banget	neg
sih kabur	neg
kadarieu loba loker didieu mah	neu
berharap pemerintah indonesia	neg
gwenchana	neu
ngemis rakyat belgu	neg
intinya setuju menambahi kalimat bpk mosok sek paham dek adekk	pos
pejabat model opo eneh iki	neg
nih nyuruh wkwkwkwk	neg
wkwkwkwk tontonan	neg
minimal hargain mendengarkan kalo orang mengomong pendapat ya situ berpendidikan orang pintar ya oh iya lupa orang pintar adab ya ya	neg
doa nyawa cabut der	neg
membuktikan pejabat negara peduli rakyatnya	neg
tuhan nerakan	neg
rakyat prioritas	neg
ndk nn ang re diak	neu
kalo mah	neu
kasih paham abangkuh	neg
ya marah kali	neg
woiya jelass kemajuan miskin negara mending kayak negara orang sih nolak rejeki	pos
hadeeh pr beta tinggal indonesia	neg
presidennya kabur yordania	neg
menteri pemerintah pemikiran koyo bocil mengambek dibeliin permenn gokk ndlogokk	neg
tukeran warga jepang	pos
kabur duluan jaman jokowi hahahahaha	neg
baperan banget wkwka	neg
lawak	neg
cerita we wkwkwk enak holiday	neu
kepala	neu
orang	neu
bang teman nya firdaus	neg
pemimpin cari solusi nyuruh kabur rakyat butuh kejelasan perbaikan disuruh pergi harapan	neg
kemana bang	neu
anjoyy moal dakeun mamang grab nya kitu mah	neu
nya membangun	neu
setuju sih	pos
kualitasmu paak yuk	neg
gass guru	neg
diomongin tuh respon statement menteri kekanak kanakan alias statement bodoh kayak menteri	neg
gass pindah ausi	neg
iya biarkan berisik	neu
gitusih	neu
dih dih mengambek bapaknya	neg
bilang dukung bantu permudah prosesnya	pos
singkat padat dih	neg
rmdn newzealand ziee	neu
mengomong mah gampang	neg
buakakak	neu
kelazz	pos
he si not even qualified be wakil mentri	neg
hem cie mengambek	neg
lupa ya bpk gajih uang rakyat loh pindah bpk pemasukan	neg
kau bilang kekanakan setuju statement nya sok what	neg
menteri laki dewasa pola pikir anak umir bicara perempuan pms	neg
kualitasnya kayak dipilih	neg
uang uang urusannya ya bapaknya bawa perasaan	neg
wow sekelas menteri jawabannya kayak remaja baperan	neg
second tantrum	neg
giliran rakyat bingung	neg
okey	neu
yaelah makan uang rakyat mending	neg
aduh pejabat jawabannya	neg
kalo mengomong anggap lucuan meronta hati	neg
lucu pejabat bawa perasaan	neg
ututu jwbnya kayak mengambek lu ctyangg deh uwek	neg
olah lepas tanggung	neg
lhaa ngamuk	neg
toddler kak	neg
modelan lu menyusahkan pengin klurar	neg
negara indonesia rakyat	neg
gass senang hati	pos
ajak biar koson betapa gunanya tuh wamen	neg
pengin banget nyolok matanya pakai lidi	neg
ok noted	neu
eh lo kalo mengomong ati ati gue rubuhin pakai eskapator	neg
abang pindah euy	neg
cih	neg
ajak kabur bang	neg
menengah bwh biarkan pungut pajak diksh bantuan biarkan memenuhi negara coba	neg
attitude diutamakan terkadang orang berpendidikan lupa bersikap	neg
tahi	neg
apalah nih	neg
wkwkwkwkkwkk tanggapan childish np	neg
puber	neg
ngamook	neg
dih kocak	neg
idih kayak bocil puber hahaha	neg
nih orang lupa kondisi apapun berbicara mesti terukur sembarangan klarifikasi kacau mereson model kayak	neg
e cah pas ditinggal kancane delikan	neu
id mehong sistem potong gaji sih	neg
lu undang ngmong kamera wkwkk	neg
pundung siaa	neg
jah	neu
mendengarkan anjing	neg
orang gampang banget kepancing terlepas gue bukti bentuk video kalo menulis mah bocah sd bjir	neg
betolan kabur pening kau	neg
konyol	neg
bertahan ya orang	neu
pov pemerintah	neu
konsep bernegara ya gua pembayar pajak ikutan komen pajak tuh gajinya program bagus dikit pemerintah pajak tuh programnya blablabla miris	neg
temannya abizar nih	neu
hussh	neu
sekolah kualitasnya	neg
beliau mengomong dimana kayak	neu
bettoeell syekalii	pos
serius pejabat mengomong	neu
alhamdullilah izinin bearti ya	pos
gamalu	neg
second sekelas menteri berpendidikan sekolah	neg
mutungan kaya yen pms wae	neg
okee gass	neg
san semangat pejuang cuan	pos
menyala teteh teteh baceprot	neg
baca komen gue diatas mbak gue pembayar pajak miris ketemu komen dikit ungkit pajak ungkit gaji pejabat aparat program bagus pemerintah ungkit kalo hasil pajak sdm kayak	neg
san nih bukti deh negara orang cuman mandiri kehidupan berbicara mandiri mnyentil mnyalahkan mandiri dewasa	pos
coba kabur biarkan beranak pengin tau sombong	neg
wkwkqk heran bang	neg
memperbaiki rules pencari kerja perbanyak lowongan kerja suruh haduhh gaji bayar	neg
parah	neg
alah mentri makan gaji buta	neg
yaudahh	neu
haha ya keingen statement	neu
kayak conie kabur	neu
blk	neu
san ya	neu
tag akunnya	neg
menyambung sdm sdm	neu
islamy infokan tiket keberangkatan	neu
kapasitas pola pikir wakil menteri setara lulus diragukan	neg
oke fine orang menterinya peduli main	neg
negara pejabat masyarakat sumber uangnya	neg
kocag lu	neg
salah asbun deh mendarah daging kebelakang wkwkwk eh asbun	neg
mikir masyarakat kabur digaji	neg
kabur ya kabur sanaaa	neg
bosnya mengomong ndas ah	neg
oke pergi indonesia	neg
edek ah	neg
oke gass oke gas	neg
buset wkwkwk	neg
benaran kejadian menangis	neg
lucunya negeriku	neg
asik acc	neu
hahahaha tertawa lembut	neu
pejabat attitude nya ya	neg
kalo tulak wahini jua ku	neu
permudah maksudnya permudah apanya	neu
byr pajak lumayan bsr bicara aduh	neg
baiklah syaa allah ku usahakan	pos
belajar nih min bab selesai doain ya	pos
wkwkw ngotak amadd	neg
gua doain lu mlarat besok	neg
kak rakyat patuh aturan pemerintah taat membayar pajak mengeluh	neu
behabaran	neu
gas jepang kang wkwk	neg
kerja becus manusia kayak bicara publik	neg
sabar kumpul modal	neu
sok oke kau	neg
weh keren cuy pph lu sejuta puluhan juta gaji lu gue ribu rendah dibanding bpjs kesehatan	neg
kuat pengin kabur	neg
kinerja lu bnerin monyet	neg
respon sekelas menteri kayak instead of at least we are trying our best for this country bullshit kayak kayak shame on you	neg
suara rakyat berharga kalo pemilu pilkada ya ges ya selebihnya kardus kosong	neg
pekok	neg
gua dibutuhin ah	neu
pemerintah kayak hadehh	neg
bayar pajak berisik	neg
sih wkwk	neu
